wwwwwwwwwwwwwwwwwwwwwww
wppppppppppwppppppppppw
wpwwwpwwwwpwpwwwwpwwwpw
wewwwpwwwwpwpwwwwpwwwew
wpppppppppppppppppppppw
wpwwwpwpwwwwwwwpwpwwwpw
wpppppwppppwppppwpppppw
wwwwwpwwwwmwmwwwwpwwwww
wpppppwmmmm1mmmmwpppppw
wpwwwpwmwwwwwwwmwpwwwpw
wpwwwpwmwm234mwmwpwwwpw
wpwwwpmmwmmmmmwmmpwwwpw
wpwwwpwmwwwwwwwmwpwwwpw
wpppppwmmmmmmmmmwpppppw
wwwwwpwmwwwwwwwmwpwwwww
wppppppppppwppppppppppw
wpwwwpwwwwpwpwwwwpwwwpw
weppwppppppPppppppwppew
wwwpwpwpwwwwwwwpwpwpwww
wpppppwppppwppppwpppppw
wpwwwwwwwwpwpwwwwwwwwpw
wpppppppppppppppppppppw
wwwwwwwwwwwwwwwwwwwwwww



w	w	w	w	w	w	w	w	w	w	w	w	w	w	w	w	w	w	w	w	w	w	w
w	p	p	p	p	p	p	p	p	p	p	w	p	p	p	p	p	p	p	p	p	p	w
w	p	w	w	w	p	w	w	w	w	p	w	p	w	w	w	w	p	w	w	w	p	w
w	e	w	w	w	p	w	w	w	w	p	w	p	w	w	w	w	p	w	w	w	e	w
w	p	p	p	p	p	p	p	p	p	p	p	p	p	p	p	p	p	p	p	p	p	w
w	p	w	w	w	p	w	p	w	w	w	w	w	w	w	p	w	p	w	w	w	p	w
w	p	p	p	p	p	w	p	p	p	p	w	p	p	p	p	w	p	p	p	p	p	w
w	w	w	w	w	p	w	w	w	w	m	w	m	w	w	w	w	p	w	w	w	w	w
w	p	p	p	p	p	w	m	m	m	m	1	m	m	m	m	w	p	p	p	p	p	w
w	p	w	w	w	p	w	m	w	w	w	w	w	w	w	m	w	p	w	w	w	p	w
w	p	w	w	w	p	w	m	w	m	2	3	4	m	w	m	w	p	w	w	w	p	w
w	p	w	w	w	p	m	m	w	m	m	m	m	m	w	m	m	p	w	w	w	p	w
w	p	w	w	w	p	w	m	w	w	w	w	w	w	w	m	w	p	w	w	w	p	w
w	p	p	p	p	p	w	m	m	m	m	m	m	m	m	m	w	p	p	p	p	p	w
w	w	w	w	w	p	w	m	w	w	w	w	w	w	w	m	w	p	w	w	w	w	w
w	p	p	p	p	p	p	p	p	p	p	w	p	p	p	p	p	p	p	p	p	p	w
w	p	w	w	w	p	w	w	w	w	p	w	p	w	w	w	w	p	w	w	w	p	w
w	e	p	p	w	p	p	p	p	p	p	P	p	p	p	p	p	p	w	p	p	e	w
w	w	w	p	w	p	w	p	w	w	w	w	w	w	w	p	w	p	w	p	w	w	w
w	p	p	p	p	p	w	p	p	p	p	w	p	p	p	p	w	p	p	p	p	p	w
w	p	w	w	w	w	w	w	w	w	p	w	p	w	w	w	w	w	w	w	w	p	w
w	p	p	p	p	p	p	p	p	p	p	p	p	p	p	p	p	p	p	p	p	p	w
w	w	w	w	w	w	w	w	w	w	w	w	w	w	w	w	w	w	w	w	w	w	w

